5 5
3 0
- ! $ - -
- - + - -
- + M + -
- - + - -
- - - - -