5 5
2 2
- ! $ - -
- M - M -
- - - - -
- M - M -
- - - - -