5 5
2 0
M ! $ - -
+ - - - -
- - M - -
- - - - -
M M - - -